0 0 0 0 0 0 0 0 0 0 0 0 0 0 0 0 0 0 0 0 0 0 0 0 0 0 0 0 0 0 0 0 0 0 0 0 0 0 0 0 0 0 0 0 0 0 0 0 0 0 
0 0 0 0 0 0 0 0 0 0 0 0 0 0 0 0 0 0 0 0 0 0 0 0 0 0 0 0 0 0 0 0 0 0 0 0 0 0 0 0 0 0 0 0 0 0 0 0 0 0 
0 0 0 0 0 0 0 0 0 0 0 0 0 0 0 0 0 0 0 0 0 0 0 0 0 0 0 0 0 0 0 0 0 0 0 0 0 0 0 0 0 0 0 0 0 0 0 0 0 0 
0 0 0 0 0 0 0 0 0 0 0 0 0 0 0 0 0 0 0 0 0 0 0 0 0 0 0 0 0 0 0 0 0 0 0 0 0 0 0 0 0 0 0 0 0 0 0 0 0 0 
0 0 0 0 0 0 0 0 0 0 0 0 0 0 0 0 0 0 0 0 0 0 0 0 0 0 0 0 0 0 0 0 0 0 0 0 0 0 0 0 0 0 0 0 0 0 0 0 0 0 
0 0 0 0 0 0 0 0 0 0 0 0 0 0 0 0 0 0 0 0 0 0 0 0 0 0 0 0 0 0 0 0 0 0 0 0 0 0 0 0 0 0 0 0 0 0 0 0 0 0 
0 0 0 0 0 0 0 50 50 50 50 50 50 50 50 50 50 50 50 50 50 50 50 50 50 50 50 50 50 50 50 50 50 50 50 50 50 50 50 50 50 50 50 0 0 0 0 0 0 0 
0 0 0 0 0 0 0 50 47 49 50 50 50 50 50 50 50 50 50 50 50 50 50 50 50 50 50 50 50 50 50 50 50 50 50 50 50 50 50 50 50 50 50 0 0 0 0 0 0 0
0 0 0 0 0 0 0 50 49 49 50 50 50 50 50 49 49 49 49 49 49 50 50 50 50 50 50 50 50 50 50 49 49 49 49 49 49 50 50 50 50 50 50 0 0 0 0 0 0 0 
0 0 0 0 0 0 0 50 50 49 50 50 50 50 49 49 49 49 49 49 49 49 50 50 50 50 50 50 50 50 49 49 49 49 50 50 49 50 50 50 50 50 50 0 0 0 0 0 0 0 
0 0 0 0 0 0 0 50 50 49 49 49 49 49 49 49 49 49 49 49 49 49 50 50 50 50 49 49 49 49 49 49 49 50 50 50 49 49 50 50 50 50 50 0 0 0 0 0 0 0 
0 0 0 0 0 0 0 50 50 50 50 50 50 50 49 49 49 49 49 49 49 49 50 50 50 49 49 49 49 49 49 49 50 50 50 50 50 49 50 50 50 50 50 0 0 0 0 0 0 0 
0 0 0 0 0 0 0 50 50 50 50 50 50 50 50 49 49 49 49 49 49 50 50 50 49 49 49 49 49 49 50 50 50 50 50 50 50 49 49 50 50 50 50 0 0 0 0 0 0 0 
0 0 0 0 0 0 0 50 50 50 50 50 50 50 50 50 50 50 49 50 50 50 50 49 49 49 49 50 50 50 50 50 50 50 50 50 49 49 49 49 50 50 50 0 0 0 0 0 0 0 
0 0 0 0 0 0 0 50 50 50 50 50 50 50 50 50 50 50 49 50 50 50 49 49 49 50 50 50 50 50 50 50 50 50 50 49 49 49 49 49 50 50 50 0 0 0 0 0 0 0 
0 0 0 0 0 0 0 50 50 50 50 50 50 50 50 49 49 49 49 49 50 50 49 49 49 50 50 49 50 50 50 50 50 50 50 49 49 49 49 49 49 50 50 0 0 0 0 0 0 0 
0 0 0 0 0 0 0 50 50 50 50 50 50 49 49 49 50 49 49 49 50 50 49 50 50 50 50 49 50 50 50 50 50 50 49 49 49 49 49 49 49 50 50 0 0 0 0 0 0 0 
0 0 0 0 0 0 0 50 49 49 50 50 50 50 50 50 50 50 49 50 50 50 49 50 50 49 49 49 49 49 50 50 49 49 49 50 50 49 49 49 50 50 50 0 0 0 0 0 0 0 
0 0 0 0 0 0 0 50 49 49 49 49 49 50 50 50 50 50 49 50 50 50 49 50 50 49 49 49 49 49 50 49 49 50 50 50 50 50 49 50 50 50 50 0 0 0 0 0 0 0 
0 0 0 0 0 0 0 50 49 49 49 49 49 50 50 50 50 50 49 50 50 50 49 50 50 49 49 49 49 49 49 49 50 50 50 50 50 50 49 50 50 50 50 0 0 0 0 0 0 0 
0 0 0 0 0 0 0 50 49 49 49 49 49 50 50 50 50 50 49 50 50 50 49 50 50 50 49 49 49 49 50 50 50 50 50 50 50 50 49 50 50 50 50 0 0 0 0 0 0 0 
0 0 0 0 0 0 0 50 49 49 49 49 49 50 50 50 50 50 49 50 50 50 49 49 50 50 50 50 50 50 50 50 50 50 50 50 50 50 49 50 50 50 50 0 0 0 0 0 0 0 
0 0 0 0 0 0 0 50 50 50 49 50 50 50 50 50 50 50 49 50 49 49 49 49 50 50 50 50 50 50 50 50 50 50 50 50 50 50 49 50 50 50 50 0 0 0 0 0 0 0 
0 0 0 0 0 0 0 50 50 50 49 50 50 50 50 50 50 50 49 50 50 50 50 50 50 50 50 50 50 50 50 50 50 50 50 50 50 49 49 49 49 50 50 0 0 0 0 0 0 0 
0 0 0 0 0 0 0 50 50 50 49 50 50 50 49 49 49 49 49 49 49 49 50 50 50 50 50 50 50 50 50 50 50 50 49 49 49 49 49 49 49 50 50 0 0 0 0 0 0 0 
0 0 0 0 0 0 0 50 50 50 49 50 50 49 49 49 49 49 49 49 49 49 49 50 50 50 50 50 50 50 50 50 49 49 49 49 49 49 49 49 49 50 50 0 0 0 0 0 0 0 
0 0 0 0 0 0 0 50 50 50 49 49 49 49 49 49 49 49 49 49 49 49 49 50 50 50 50 50 50 50 50 50 49 49 49 49 49 49 49 49 49 50 50 0 0 0 0 0 0 0 
0 0 0 0 0 0 0 50 50 50 49 49 49 49 49 49 49 49 49 49 49 49 49 50 50 50 50 50 50 50 50 50 49 49 49 49 49 49 49 49 49 50 50 0 0 0 0 0 0 0 
0 0 0 0 0 0 0 50 50 50 50 50 50 50 49 49 49 49 49 49 49 49 49 49 49 49 49 49 49 49 49 49 49 49 49 49 49 50 50 49 49 50 50 0 0 0 0 0 0 0 
0 0 0 0 0 0 0 50 50 50 50 50 50 50 50 50 50 49 49 50 50 50 50 50 50 50 49 50 50 50 50 50 49 49 49 50 50 50 50 49 49 50 50 0 0 0 0 0 0 0 
0 0 0 0 0 0 0 50 50 50 50 50 50 50 50 50 50 49 49 50 50 50 50 50 50 50 49 50 50 50 50 50 50 50 50 50 50 50 49 49 49 50 50 0 0 0 0 0 0 0 
0 0 0 0 0 0 0 50 50 50 50 50 50 50 50 50 50 49 49 50 50 50 50 50 50 50 49 50 50 50 50 50 50 50 50 50 50 50 50 49 49 50 50 0 0 0 0 0 0 0 
0 0 0 0 0 0 0 50 50 50 50 50 50 50 50 50 50 49 49 50 50 50 50 50 50 50 49 50 50 50 50 50 50 50 50 50 50 50 50 50 50 50 50 0 0 0 0 0 0 0 
0 0 0 0 0 0 0 50 50 50 50 50 50 50 50 50 50 49 49 50 50 50 50 50 50 49 49 49 50 50 50 50 50 50 50 50 50 50 50 50 50 50 50 0 0 0 0 0 0 0 
0 0 0 0 0 0 0 50 50 50 50 50 50 50 50 50 50 49 49 50 50 50 50 50 50 49 49 49 50 50 50 50 50 50 50 50 50 50 50 50 50 50 50 0 0 0 0 0 0 0 
0 0 0 0 0 0 0 50 50 50 50 50 50 50 50 49 49 49 49 49 49 50 50 50 50 50 50 50 50 50 50 50 50 50 50 50 50 50 50 50 50 50 50 0 0 0 0 0 0 0 
0 0 0 0 0 0 0 50 50 50 50 50 50 50 50 49 49 49 49 49 49 50 50 50 50 50 50 50 50 50 50 50 50 50 50 50 50 50 50 50 50 50 50 0 0 0 0 0 0 0 
0 0 0 0 0 0 0 50 50 49 49 49 49 49 49 49 49 49 49 49 49 50 50 50 50 50 50 50 50 50 50 50 50 50 50 50 49 49 49 49 49 50 50 0 0 0 0 0 0 0 
0 0 0 0 0 0 0 50 50 49 50 50 50 50 50 49 49 49 49 49 49 50 50 50 50 50 50 50 50 50 50 50 49 49 49 49 49 49 50 50 49 50 50 0 0 0 0 0 0 0 
0 0 0 0 0 0 0 50 50 49 50 50 50 50 50 49 49 49 49 49 49 50 50 50 50 50 50 50 50 50 50 49 49 49 49 49 49 50 50 50 49 50 50 0 0 0 0 0 0 0 
0 0 0 0 0 0 0 50 49 49 49 50 50 50 50 49 49 49 49 49 49 49 49 49 49 49 49 49 49 49 49 49 49 49 49 49 49 50 50 50 49 50 50 0 0 0 0 0 0 0 
0 0 0 0 0 0 0 50 49 48 49 50 50 50 50 50 50 50 50 50 50 50 50 50 50 50 50 50 50 50 50 50 49 49 49 49 49 50 50 50 49 50 50 0 0 0 0 0 0 0
0 0 0 0 0 0 0 50 49 49 49 50 50 50 50 50 50 50 50 50 50 50 50 50 50 50 50 50 50 50 50 50 50 50 50 50 50 50 50 50 50 50 50 0 0 0 0 0 0 0 
0 0 0 0 0 0 0 50 50 50 50 50 50 50 50 50 50 50 50 50 50 50 50 50 50 50 50 50 50 50 50 50 50 50 50 50 50 50 50 50 50 50 50 0 0 0 0 0 0 0 
0 0 0 0 0 0 0 0 0 0 0 0 0 0 0 0 0 0 0 0 0 0 0 0 0 0 0 0 0 0 0 0 0 0 0 0 0 0 0 0 0 0 0 0 0 0 0 0 0 0 
0 0 0 0 0 0 0 0 0 0 0 0 0 0 0 0 0 0 0 0 0 0 0 0 0 0 0 0 0 0 0 0 0 0 0 0 0 0 0 0 0 0 0 0 0 0 0 0 0 0 
0 0 0 0 0 0 0 0 0 0 0 0 0 0 0 0 0 0 0 0 0 0 0 0 0 0 0 0 0 0 0 0 0 0 0 0 0 0 0 0 0 0 0 0 0 0 0 0 0 0 
0 0 0 0 0 0 0 0 0 0 0 0 0 0 0 0 0 0 0 0 0 0 0 0 0 0 0 0 0 0 0 0 0 0 0 0 0 0 0 0 0 0 0 0 0 0 0 0 0 0 
0 0 0 0 0 0 0 0 0 0 0 0 0 0 0 0 0 0 0 0 0 0 0 0 0 0 0 0 0 0 0 0 0 0 0 0 0 0 0 0 0 0 0 0 0 0 0 0 0 0 
0 0 0 0 0 0 0 0 0 0 0 0 0 0 0 0 0 0 0 0 0 0 0 0 0 0 0 0 0 0 0 0 0 0 0 0 0 0 0 0 0 0 0 0 0 0 0 0 0 0 
